111111111111111111111111111111111111111111111111111111111111111
100000000000000C00000000000000000000000000000000000000000000C01
100000000000000100000000000000000001111110000000000000000000C01
100000000000001C00000000000000000010000110000000000000000000C01
100000000000010C00000000000000000000001100000000000000000000C01
100000000000100C00000000000000000000011000000000000000000000C01
1000000000011111111000C0000000000000110000000000000000000000C01
100000000000000C11000000000000000001111110000000000000000000C01
1P0000000000000C00000000000000000000000000000000000000000000CE1
111111111111111111111111111111111111111111111111111111111111111