111111111111111111111111111111111111
100C00000000000000C0000000C00C010001
101C0111100000010000111100C00C010001
101C000000C000100001000100C00C010001
101C00C000000100C000001000C010010C01
101000C00000100C00000100C0C010010C01
100000100C0111110C0C1000000010000C01
1000C010000000010CC11111C00010C00C01
1P0000100C00000000000000000010C00CE1
111111111111111111111111111111111111